00000000000000000000000000000
01111111111110011111111111100
01000010000010010000010000100
01000010000010010000010000100
01000010000010010000010000100
01111111111111111111111111100
01000010010000000010010000100
01000010010000000010010000100
01111110011110011110011111100
00000010000010010000010000000
00000010000010010000010000000
00000010011111111110010000000
00000010010000000010010000000
00000010010000000010010000000
11111111110000000011111111111
00000010010000000010010000000
00000010010000000010010000000
00000010011111111110010000000
00000010010000000010010000000
00000010010000000010010000000
01111111111110011111111111100
01000010000010010000010000100
01000010000010010000010000100
01110011111111111111110011100
00010010010000000010010010000
00010010010000000010010010000
01111110011110011110011111100
01000000000010010000000000100
01000000000010010000000000100
01111111111111111111111111100
00000000000000000000000000000
